--------------------------------
--------------------------------
--------------------------------
--------------------------------
--------------------------------
--------------------------------
----------------------!---------
--------------------------------
--------------------------------
--------------------------------
----------------!---S?S!S-------
--------------------------------
----------------------------<>--
---M-----------------g------[]--
XXXXXXXXXXXXXXXXXXXXXXXXXXXXXXXX
XXXXXXXXXXXXXXXXXXXXXXXXXXXXXXXX